1111111111
100C1E0001
1011100001
1PCC0W0001
111W000011
1111111111
