1111111
100C1E1
1011101
1P0C001
1110X01
1111111
