11111111111111111111
100100000C0000000CC1
100001111111110C00E1
10000001W10000000001
1P101101010000C00001
110010W00C000000C001
11111111111111111111
