11111111111111111111
100100000C00000001C1
100001111111110C00E1
10P0000000000P000001
1P001100000000C00001
110010000C000000C001
11111111111111111111
