111111111111111
100000000000001
101110111011101
100C00001000001
101011101110101
100000C000000C1
101011101110101
100000000000001
101110101011101
10C000010P000C1
101011101110101
100000000000001
101110111011101
1C0000000F000E1
111111111111111
