111111111111111111111111111111111111
100000000000000000000000000000000001
100000111011100000000000000000000001
100C00001000000000000001111100000001
101011101110100011111100000000C00001
100000C000000C0011111011110000000001
101011101110100000000000000000000001
100000000000000001111111000001111001
1011101010111000000000111100000X0001
10C000010P000C0001111000000000000001
100000000000100000000111110000000001
1000000000000000000000000C0000000001
1000000000000000000000000000000E0001
1C0000000000010000000001111111100001
111111111111111111111111111111111111
