1111111
100C0E1
1010101
1P0C001
1000001
1111111
