1111111111111
1001000000001
1000011111001
1P001100000C1
1111111111111