11111111111111111111
100100C00000000000E1
10000111111111C00001
100000C0000000000001
1P0011000000000000C1
11001C000000C0000001
11111111111111111111
