111111111
1P00011C1
101100001
100000111
111100001
10C101001
1100000E1
111111111