11111111111111111111
100100000C00000001C1
100001111111110C0001
10P00000000000000001
10001100000000C00001
110010000C000000C0E1
11111111111111111111
